Class Name	BEL Encoding
?	A
anatomy	A
antibody	A
biological process	B
cellular component	A
chemical	A
chemical class	A
chemical role	A
domain	P
enzyme class	P
epitope	P
exposure	O
isoform	P
motif	P
pathology	O
pathway	B
peptide	AP
post-translational modification	Y
protein	P
protein fragment	P
protein complex	P
protein family	P
protein variant	P
genetic variant	G
